+-+-+-+-+-+-+-+-+-+-+
|S      |           |
+-+-+-+ + +-+-+-+-+ +
| |     |   |     | |
+ + +-+-+-+ + + +-+ +
|   | |     | | |   |
+ +-+ + + +-+-+ + +-+
| |     | |     |   |
+ +-+-+-+ + +-+ +-+ +
| |       | |     | |
+ + +-+-+-+ + + +-+ +
| | |   |     |     |
+ + + + +-+ +-+-+-+-+
| |   |   |   |     |
+ +-+-+-+ +-+ +-+ + +
|       |   | |   | |
+-+-+-+ + + + + +-+ +
|   |   | | | |   | |
+ + + +-+-+ + +-+ + +
| |         |     |F|
+-+-+-+-+-+-+-+-+-+-+